NO ./textures/NO.png
SO ./textures/SO.png
WE ./textures/WE.png
 EA ./textures/EA.png

C 100,150,150
F 220, 150, 0

        1111111111111111111111111111111111111111
        1111100000W110000000000000000000000001111
        10110000011100000000000011111111111111111
        1001000000100000000000001
11111111011000001110000000000001       
10000000001100000111111111111111 
11110111111100000011100000010001      
11110111111000000011101010010001     
11000000110100000000000000010001
10000000000000001100000010101111
1000000000000000110101001000111111111111111111111111
110000001110101011111011110111111
11110111 1110101 101111011111
 11110111 11101011001111010001
1 1110111 11111011001111010001
11 110111 111 1110001111010001
11110111 111 10111011111000111
11111111 111 111 111111111111









