NO ./texturs/NO.png
SO ./texturs/SO.png
WE ./texturs/WE.png
EA ./texturs/EA.png

C   45,45,45
F   64,64,64

        11111111111111111111111111111
        11111000000110000000000001111
        10110000011100000000000011
        1001000000000000000000001
11111111011000001110000000000001
10000000001100000111011111111111
11110111111111011100000010001
11110111111111011101010010001
11000000110101011100000010001
10000000000000001100000010001
10000000000000001101010010001
110000011101010111110111N0111
11110111 1110101 101111010001
11111111 1111111 111111111111

