NO ./textures/NO.png
SO ./textures/SO.png
WE ./textures/WE.png
EA ./textures/EA.png


F 220,100,1
C 225,30,1

11111111111111111111111111111
10110000011100000000000011111
10010000000000000000000001
1111111110110000011100001
100000000011000001110111111111111
11110111111111011100000010001
111101N1111111011101010010001
11000000110101011100000010001
1000000000000000110000010001
10000000000000001101010010001
11000001110101011110111100111
11110111 1110101 10111101001
111111 1111111 1111111111111