NO ./texturs/NO.png
SO ./texturs/SO.png
WE ./texturs/WE.png
EA ./texturs/EA.png

C   45,45,45
F   64,64,64

        11111111111111111111111111111
        11111000000110000000000001111
        10110000011100000000000011
        1001000000100000000000001
11111111011000001110000000000E01        
10000000001100000111111111111111 
11110111111111011100000010001      
11110111111111011101010010001     
11000000110101011100000010001
10000000000000001100000010101
1000000000000000110101001000111111111111111111111111
11000001110101011111011110111111
11110111 1110101 101111011111
 11110111 1110101 101111010001
1 1110111 1111101 101111010001
11 110111 111 101 101111010001
11110111 111 101 101111010001
11111111 111 111 111111111111
