                           
NO ./textures/NO.png
SO ./textures/SO.png
WE ./textures/WE.png
 EA ./textures/EA.png

F 32,32,0
C 0,25,51

    1111111111111111111
    100000100000001
    10000111111111111111111111
    10000011000010000000010001
    10000010000100000000000011
    10000011000010000000010001
    11101111111011111111110001
    11000011000000110001111111
    10000001000000110001
    10000001000000110001
    100000000000001111111111111111111111111
    100000010000001000000000000000000011111
    100000010000001000000000000000000011111
    110000110000001001110000000000110010001
    111111111111111001000000000000010010001
    100000000000000000010001111111111111111
    1000000000000000000010001
    1000000000000000000000011
    100000000000000000W010001
    1111111111111111111111111